bleu 1 1 Sud
==========
=    x   =
=  = ==  =
= x  =   =
= =  =   =
= x  =   =
= =  x = =
=  =  =  =
==========
